
R	1500 1500
S		   			./textures/barrel.xpm		 	 	   	 		
NO		 	   ./textures/north.xpm
SO  ./textures/south.xpm    
WE  ./textures/west.xpm 
EA  ./textures/east.xpm 
F   220,		255, 10
C  255  , 	60	,	10


1111111111111111
1E00000000010001
1000000111000101
1000001  1111001
1201111111111011
1000000000000001 
1010101001010101
1201111001111111
1111111001111111
1200000000000021
1100000000000011
1200000000000021
1100000000000011
1200000000000021
1121212002121211
1111111001111111
1100000000000011
1111111001111111
1111111001111111
1111111001111111
1111111001111111
1111111001111111
1111111001111111
1111111001111111
1111111001111111
1111111001111111
1111111001111111
1111111001111111
1111111001111111
1111111001111111
1111111001111111
1111111111111111