R     1000      1000               
S   ./textures/barrel.xpm
NO  ./textures/north.xpm    
SO  ./textures/south.xpm    
WE  ./textures/west.xpm 
EA  ./textures/east.xpm 
F 220, 255, 255                       
 255, 60   ,225        



111111111111111111111111111111
1111111111121011111111111111111
1022222200000000200000000000001
11011111110N0001111111001100111
1000001  1010011   100200000011
100001   1020121  10000202011
1111111111111111111111111111111
1111111111111 11111111111111111