10.ox
oo.o.o..o.
o...ooo...
oo.oo.o..o
oo....o.o.
o..oo.....
ooo.o.....
.o..oo.o..
..o..ooo.o
o.....oo..
.oo.o....o