10.ox
.......ooo
..........
..o...oo..
....ooo...
.......o.o
..........
........o.
.....ooo..
o..o.o..o.
......o...