R  1000 1000
S      ./textures/barrel.xpm 
NO       ./textures/north.xpm        
SO     ./textures/south.xpm         
WE                             ./textures/west.xpm                     
EA     ./textures/east.xpm
F 255, 255, 255
C 200, 60   ,220    

1111111111111111111111111111111
1111111111101011111111111111111
10222222000000002000000000000001
11011111111N1001111111001100111
1000001  1010011   100200000011
100001    1020121   100002020111
1111111111111111111111111111111