R  1000 1000
S      ./textures/barrel.xpm 
NO       ./textures/north.xpm        
SO     ./textures/south.xpm         
WE                             ./textures/west.xpm                     
EA     ./textures/east.xpm
F 255, 255, 255
C 200, 60   ,220    

1111111111111111111111111111111
11111111111111011111111111111111
10222222000010000020000000000001
11011111110S0001111111001100011111
10001    1000011   1002000000111111
10001    10201211  1000020201111111
1111111111111111111111111111111111