       111111111111111111111111
1111111100000000000000000000001
1000000000011110000000011111111
100000000001111000000001
100000000001111000000001
100000000000000000000001
111111111111111111111111