S            ./textures/pillar.xpm               


R                   900 600                
NO           ./textures/north.xpm
SO     ./textures/south.xpm           

WE                             ./textures/west.xpm          
EA     ./textures/east.xpm    
F 220,100,0
C 225,30,0

111111111111111111111111111111
111111111E00000001000000011111
100011111100000001111111100111
10001    10000000001  10000001
10001    10000000001  10000001
111111111111100000011111111111
111111111111111111111111111111