R     900 600
S            ./textures/pillar.xpm         
      
NO           ./textures/north.xpm
SO     ./textures/south.xpm           

WE                             ./textures/west.xpm          
EA     ./textures/east.xpm
FLOOR   ./textures/wood.xpm
F 0   ,25    ,80
C 145 , 0,   80

11111111111111111111111111111111
11111111111111011111111111111111
10222222000000000000200000000001
111111111120N0011111110011000111
10001    101200011  100200000111
10001    100012101  100002020111
11111111111111000111111111111111
11111111111111111111111111111111