       1111111111111     11111111111   
1111111100000000000000000000001
1000000000011110000000011111111
1000000000011110000000000
010001111000011110000000001
10001  100000N000000000001
11111  1111111111111111111