R                   900 600             
S            ./textures/pillar.xpm               
NO           ./textures/north.xpm
SO     ./textures/south.xpm           

WE                             ./textures/west.xpm          
EA     ./textures/east.xpm    
F 220,100,0
C 225,30,0

11111111111111111111111111111111
11111111111111011111111111111111
10000000000000001000000011111111
11111111110000N00111111100111111
10001    10100000011  1000000111
10001    10001010101  1000000111
11111111111111000111111111111111
11111111111111111111111111111111