S            ./textures/pillar.xpm               


R                   900 600                
NO           ./textures/north.xpm
SO     ./textures/south.xpm           

WE                             ./textures/west.xpm          
EA     ./textures/east.xpm    
F 220,100,0
C 225,30,0

11111111111111111111111111111111
11111111111111011111111111111111
10110101000000001000000011111111
111111111100000N0111111100111111
10001    10000000001  1000000111
10001    10001010101  1000000111
11111111111111000111111111111111
11111111111111111111111111111111