R     900 600
S            ./textures/pillar.xpm         
      
NO           ./textures/north.xpm
SO     ./textures/south.xpm           

WE                             ./textures/west.xpm          
EA     ./textures/east.xpm
FLOOR   ./textures/wood.xpm
F 0   ,25    ,80
C 145 , 0,   80

11111111111111111111111111111111
11111111111111011111111111111111
10000000000000001000000011111111
11111111110000N00111111100111111
10001    10100000011  1000000111
10001    10000100101  1000000111
11111111111111000111111111111111
11111111111111111111111111111111