R     900 600
S            ./textures/barrel.xpm         
      
NO           ./textures/north.xpm
SO     ./textures/south.xpm           

WE                             ./textures/west.xpm          
EA     ./textures/east.xpm
FLOOR   ./textures/wood.xpm
F 0   ,25    ,80
C 145 , 0,   80

11111111111111111111111111111111
11111111111111011111111111111111
102222220000100000200000000001
111111111111N1011111110011000111
10001    10010011  1002000000111
10001    100012101  100002020111
11111111111111000111111111111111
11111111111111111111111111111111